



   WE                            ./textures/wolfenstein/grey_stone.xpm
NO      ./textures/wolfenstein/purple_stone.xpm
F      17,38,64
SO ./textures/wolfenstein/red_brick.xpm
EA ./textures/wolfenstein/wood.xpm




C 218,234,235

1111111111111111111111111
10S0110000100000000000001
1000110000000000111111000 
            1
1000110000000000110001001
1000000000100000000001001
1111111111111111111111111
