NO wool/black_wool.xpm
SO      wool/yellow_wool.xpm
WE                   wool/cyan_wool.xpm                         
EA wool/red_wool.xpm
F 42,98,61
C 171,191,210
111111111111111111111111111111111111111111111111
100000000100000000000000000000000000000000000001
100000000100000000000000000000000000000000000001
100000000100000000000000000000000000000000000001
100000000100000000000000000000000000000000000001
100000000100000000000000000000000000000000000001
100000000000000000000000000000000000000000000001
100000000000000000000000000000000000000000000001
100000000000000000000000000000000000000000000001
100000000000000000000000000000000000000000000001
100000000000000000000000000000N00000000000000001
100000000000000000000000000000000000000000000001
100000000000000000000000000000000000000000000001
100000000000000000000000000000000000000000000001
100000000000000000000000000000000000000000000001
100000000000000000000000000000000000001000000001
100000000000000000000000000000000000000000000001
100000000000000000000000000000000000000000000001
100000000000000000000000000000000000000000000001
100000000000000000000000000000000000000000000001
100000000000000000000000000000000000000000000001
100000000000000000000000000000000000000000000001
100000000000000000000000000000000000000000000001
100000000000000000000000000000000000000000000001
100000000000000000000000000000000000000000000001
100000000000000000000000000000000000000000000001
111111111111111111111111111111111111111111111111
