NO ./textures/2020.xpm
SO ./textures/cover/astro.xpm
WE ./textures/cover/heros.xpm
EA ./textures/cover/goodkidmadcity.xpm
F 169,169,169
C 49,140,231

111111111   1
10000000111011111
100000001
1N00000011111111
100000001
111111111