NO ./textures/2020.xpm
C 225,30,      0   
SO ./textures/wolfenstein/purple_stone.xpm        
F 220,1,,5
EA ./textures/wolfenstein/wood.xpm
WE ./textures/wolfenstein/red_brick.xpm       

111111
1N1111
100001
111111