NO ./textures/eagle.xpm
SO      ./textures/bluestone.xpm
WE                   ./textures/redbrick_1.xpm                         
EA ./textures/wood.xpm
F 42,98,61
C 171,191,210
111111111111111111111111
100100000000000000000001
100100000000000000000001
100100000000000000000001
100100000000000000000001
100100000000000000000001
100000000000000000000001
100000000000000000000001
100000000000000000000001
100000000000000000000001
1000000000N0000000000001
100000000000000000000001
100000000000000000000001
100000000000000000000001
100000000000000000000001
100000000000000000000001
100000000000000000000001
100000000000000000000001
100000000000000000000001
100000000000000000000001
100000000000000000000001
100000000000000000000001
100000000000000000000001
111111111111111111111111